Afghanistan	 opium, fruits, nuts, handwoven carpets, wool, cotton, hides, pelts, gems
Albania	 textiles, footwear, asphalt, metals, metallic ores, oil, vegetables, fruits, tobacco
Algeria	 petroleum, natural gas, petroleum products
American Samoa	 tuna
Andorra	 tobacco products, furniture
Angola	 oil, diamonds, refined petroleum products, coffee, sisal, fish, fish products, timber, cotton
Anguilla	 lobster, fish, livestock, salt, concrete blocks, rum
Antigua and Barbuda	 petroleum products, bedding, handicrafts, electronic components, transport equipment, food, live animals
Argentina	 soybeans, petroleum, gas, vehicles, corn, wheat
Armenia	 pig iron, copper, metals, diamonds, mineral products, foodstuffs, energy
Aruba	 live animals, animal products, art, collectibles, machinery, electrical equipment, transport equipment
Australia	 coal, iron ore, gold, meat, wool, alumina, wheat, machinery, transport equipment
Austria	 machinery, motor vehicles, paper, paperboard, metal goods, chemicals, iron, steel, textiles, foodstuffs
Azerbaijan	 oil, gas, machinery, cotton, foodstuffs
Bahamas	 mineral products, salt, animal products, rum, chemicals, fruit, vegetables
Bahrain	 petroleum, petroleum products, aluminum, textiles
Bangladesh	 garments, knitwear, agricultural products, frozen food, fish, seafood, jute, jute goods, leather
Barbados	 manufactures, sugar, molasses, rum, other foods, beverages, chemicals, electrical components
Belarus	 machinery, mineral products, chemicals, metals, textiles, foodstuffs
Belgium	 machinery, chemicals, finished diamonds, metals, metal products, foodstuffs
Belize	 sugar, bananas, citrus, clothing, fish products, molasses, wood, oil
Benin	 cotton, cashews, shea butter, textiles, palm products, seafood
Bermuda	 pharmaceuticals
Bhutan	 electricity, ferrosilicon, cement, calcium carbide, copper wire, manganese, vegetable oil
Bolivia	 natural gas, soybeans, soy products, crude petroleum, zinc ore, tin
Bosnia and Herzegovina	 metals, clothing, wood products
Botswana	 diamonds, copper, nickel, soda ash, meat, textiles
Brazil	 transport equipment, iron ore, soybeans, footwear, coffee, autos
British Virgin Islands	 rum, fresh fish, fruits, animals, gravel, sand
Brunei	 oil, natural gas, garments
Bulgaria	 clothing, footwear, iron, steel, machinery, fuels
Burkina Faso	 gold, cotton, livestock
Burma	 natural gas, wood products, pulses, beans, fish, rice, clothing, jade, gems
Burundi	 coffee, tea, sugar, cotton, hides
Cambodia	 clothing, timber, rubber, rice, fish, tobacco, footwear
Cameroon	 oil, petroleum products, lumber, cocoa beans, aluminum, coffee, cotton
Canada	 motor vehicles, industrial machinery, aircraft, telecommunications equipment, chemicals, plastics, fertilizers, wood pulp, timber, crude petroleum, natural gas, electricity, aluminum
Cape Verde	 fuel, shoes, garments, fish, hides
Cayman Islands	 turtle products, manufactured goods
Central African Republic	 diamonds, timber, cotton, coffee, tobacco
Chad	 oil, cattle, cotton, gum arabic
Chile	 copper, fruit, fish products, paper, pulp, chemicals, wine
China	 electrical machinery, apparel, textiles, iron, steel, optical equipment, medical equipment
Christmas Island	 phosphate
Cocos (Keeling) Islands	 copra
Colombia	 petroleum, coal, emeralds, coffee, nickel, cut flowers, bananas, apparel
Comoros	 vanilla, ylang-ylang, cloves, copra
Democratic Republic of the Congo	 diamonds, gold, copper, cobalt, wood products, oil, coffee
Republic of the Congo	 petroleum, lumber, plywood, sugar, cocoa, coffee, diamonds
Cook Islands	 copra, papayas, citrus, coffee, fish, pearls, pearl shells, clothing
Costa Rica	 bananas, pineapples, coffee, melons, ornamental plants, sugar, beef, seafood, electronic components, medical equipment
Cote d'Ivoire	 cocoa, coffee, timber, petroleum, cotton, bananas, pineapples, palm oil, fish
Croatia	 transport equipment, machinery, textiles, chemicals, foodstuffs, fuels
Cuba	 sugar, nickel, tobacco, fish, medical products, citrus, coffee
Curacao	 petroleum products
Cyprus	 citrus, potatoes, pharmaceuticals, cement, clothing
Czech Republic	 machinery, transport equipment, raw materials, fuel, chemicals
Denmark	 machinery, instruments, meat, meat products, dairy products, fish, pharmaceuticals, furniture, windmills
Djibouti	 hides, skins, coffee
Dominica	 bananas, soap, bay oil, vegetables, grapefruit, oranges
Dominican Republic	 ferronickel, sugar, gold, silver, coffee, cocoa, tobacco, meats, consumer goods
Ecuador	 petroleum, bananas, cut flowers, shrimp, cacao, coffee, wood, fish
Egypt	 oil, petroleum products, cotton, textiles, metal products, chemicals, food
El Salvador	 offshore assembly exports, coffee, sugar, textiles, apparel, gold, ethanol, chemicals, electricity, iron, steel manufactures
Equatorial Guinea	 petroleum products, timber
Eritrea	 livestock, sorghum, textiles, food, small manufactures
Estonia	 machinery, electrical equipment, wood, wood products, metals, furniture, vehicles, food products, beverages, textiles, plastics
Ethiopia	 coffee, khat, gold, leather products, live animals, oilseeds
European Union	 machinery, motor vehicles, pharmaceuticals, chemicals, fuels, aircraft, plastics, iron, steel, wood pulp, paper products, alcoholic beverages, furniture
Falkland Islands	 wool, hides, meat, venison, fish, squid
Faroe Islands	 fish, fish products, stamps, ships
Fiji	 sugar, garments, gold, timber, fish, molasses, coconut oil
Finland	 electrical equipment, optical equipment, machinery, transport equipment, paper, pulp, chemicals, metals, timber
France	 machinery, transportation equipment, aircraft, plastics, chemicals, pharmaceutical products, iron, steel, beverages
French Polynesia	 cultured pearls, coconut products, mother-of-pearl, vanilla, shark meat
Gabon	 oil, timber, manganese, uranium
Gambia, The	 peanut products, fish, cotton lint, palm kernels
Gaza Strip	 strawberries, carnations, vegetables
Georgia	 vehicles, ferro-alloys, fertilizers, nuts, scrap metal, gold, copper ores
Germany	 motor vehicles, machinery, chemicals, computers, electronic products, electrical equipment, pharmaceuticals, metals, transport equipment, foodstuffs, textiles, rubber products, plastic products
Ghana	 gold, cocoa, timber, tuna, bauxite, aluminum, manganese ore, diamonds, horticultural products
Gibraltar	 manufactured goods
Greece	 food, beverages, manufactured goods, petroleum products, chemicals, textiles
Greenland	 fish, fish products, metals
Grenada	 nutmeg, bananas, cocoa, fruit, vegetables, clothing, mace
Guam	 construction materials, fish, food, beverage products
Guatemala	 coffee, sugar, petroleum, apparel, bananas, fruits, vegetables, cardamom
Guernsey	 tomatoes, flowers, ferns, sweet peppers, eggplant, vegetables
Guinea	 bauxite, alumina, gold, diamonds, coffee, fish, agricultural products
Guinea-Bissau	 fish, shrimp, cashew nuts, peanuts, palm kernels, sawn lumber
Guyana	 sugar, gold, bauxite, alumina, rice, shrimp, molasses, rum, timber
Haiti	 apparel, manufactures, oils, cocoa, mangoes, coffee
Honduras	 apparel, coffee, shrimp, automobile wire harnesses, cigars, bananas, gold, palm oil, fruit, lobster, lumber
Hong Kong	 electrical machinery, appliances, textiles, apparel, footwear, watches, clocks, toys, plastics, precious stones, printed material
Hungary	 machinery, equipment, food products, raw materials, fuels, electricity
Iceland	 fish, fish products, aluminum, animal products, ferrosilicon, diatomite
India	 petroleum products, precious stones, machinery, iron, steel, chemicals, vehicles, apparel
Indonesia	 oil, gas, electrical appliances, plywood, textiles, rubber
Iran	 petroleum, chemical products, petrochemical products, fruits, nuts, carpets
Iraq	 oil, crude materials excluding fuels, food, live animals
Ireland	 machinery, equipment, computers, chemicals, medical devices, pharmaceuticals, food products, animal products
Isle of Man	 tweeds, herring, shellfish, beef, lamb
Israel	 machinery, software, diamonds, agricultural products, chemicals, textiles, apparel
Italy	 engineering products, textiles, clothing, production machinery, motor vehicles, transport equipment, chemicals, food, beverages, tobacco, minerals
Jamaica	 alumina, bauxite, sugar, rum, coffee, yams, beverages, chemicals, wearing apparel, mineral fuels
Japan	 motor vehicles, semiconductors, iron products, steel products, auto parts, plastic materials, power generating machinery
Jersey	 electrical goods, dairy cattle, foodstuffs, textiles, flowers
Jordan	 clothing, fertilizers, potash, phosphates, vegetables, pharmaceuticals
Kazakhstan	 oil, oil products, metals, chemicals, machinery, grain, wool, meat, coal
Kenya	 tea, horticultural products, coffee, petroleum products, fish, cement
Kiribati	 copra, coconuts, seaweed, fish
North Korea	 minerals, metallurgical products, manufactures, textiles, agricultural products, fishery products
SouthKorea	 semiconductors, wireless telecommunications equipment, motor vehicles, computers, steel, ships, petrochemicals
Kosovo	 mining products, metal, leather products, machinery, appliances, prepared foodstuffs, beverages, tobacco, vegetable products, textile, textile articles
Kuwait	 oil, fertilizers
Kyrgyzstan	 gold, cotton, wool, garments, meat, tobacco, mercury, uranium, hydropower, machinery, shoes
Laos	 wood products, coffee, electricity, tin, copper, gold
Latvia	 food products, wood, wood products, metals, machinery, textiles
Lebanon	 jewelry, base metals, chemicals, fruit, vegetables, tobacco, construction minerals, electric power machinery, switchgear, textile fibers, paper
Lesotho	 clothing, footwear, road vehicles, wool, mohair, food, live animals
Liberia	 rubber, timber, iron, diamonds, cocoa, coffee
Libya	 oil, refined petroleum products, natural gas, chemicals
Liechtenstein	 small specialty machinery, parts for motor vehicles, dental products, hardware, prepared foodstuffs, electronic equipment, optical products
Lithuania	 mineral products, machinery, equipment, chemicals, textiles, foodstuffs, plastics
Luxembourg	 machinery, equipment, steel products, chemicals, rubber products, glass
Macau	 clothing, textiles, footwear, toys, electronics, machinery
Macedonia	 food, beverages, tobacco, textiles, miscellaneous manufactures, iron, steel
Madagascar	 coffee, vanilla, shellfish, sugar, cotton cloth, clothing, chromite, petroleum products
Malawi	 tobacco, tea, sugar, cotton, coffee, peanuts, wood products, apparel
Malaysia	 electronic equipment, petroleum, natural gas, wood, wood products, palm oil, rubber, textiles, chemicals
Maldives	 fish
Mali	 cotton, gold, livestock
Malta	 machinery, mechanical appliances, mineral fuels, oils, products, pharmaceutical products, printed books, newspapers, aircraft, toys, games, sports requisites
Marshall Islands	 copra cake, coconut oil, handicrafts, fish
Mauritania	 iron ore, fish, fish products, gold, copper, petroleum
Mauritius	 clothing, textiles, sugar, cut flowers, molasses, fish
Mexico	 manufactured goods, oil, oil products, silver, fruits, vegetables, coffee, cotton
Micronesia	 fish, garments, bananas, black pepper, sakau (kava), betel nut
Moldova	 foodstuffs, textiles, machinery
Mongolia	 copper, apparel, livestock, animal products, cashmere, wool, hides, fluorspar, other nonferrous metals, coal, crude oil
Montserrat	 electronic components, plastic bags, apparel, hot peppers, limes, live plants, cattle
Morocco	 clothing, textiles, electric components, chemicals, transistors, crude minerals, fertilizers, petroleum products, citrus fruits, vegetables, fish
Mozambique	 aluminum, prawns, cashews, cotton, sugar, citrus, timber, bulk electricity
Namibia	 diamonds, copper, gold, zinc, lead, uranium, cattle, processed fish, karakul skins
Nauru	 phosphates
Nepal	 clothing, pulses, carpets, textiles, juice, pashima, jute goods
Netherlands	 machinery, equipment, chemicals, fuels, foodstuffs
New Caledonia	 ferronickels, nickel ore, fish
New Zealand	 dairy products, meat, wood, wood products, fish, machinery
Nicaragua	 coffee, beef, shrimp, lobster, tobacco, sugar, gold, peanuts, cigars, automobile wiring harnesses, textiles, apparel
Niger	 uranium ore, livestock, cowpeas, onions
Nigeria	 petroleum, petroleum products, cocoa, rubber
Niue	 canned coconut cream, copra, honey, vanilla, passion fruit products, pawpaws, root crops, limes, footballs, stamps, handicrafts
Norfolk Island	 postage stamps, seeds of the Norfolk Island pine, Kentia palm, small quantities of avocados
Northern Mariana Islands	 garments
Norway	 petroleum, petroleum products, machinery, equipment, metals, chemicals, ships, fish
Oman	 petroleum, fish, metals, textiles
Pakistan	 textiles, rice, leather goods, sports goods, chemicals, manufactures, carpets, rugs
Palau	 shellfish, tuna, copra, garments
Panama	 gold, bananas, shrimp, sugar, iron, steel waste, pineapples, watermelons
Papua New Guinea	 oil, gold, copper ore, logs, palm oil, coffee, cocoa, crayfish, prawns
Paraguay	 soybeans, feed, cotton, meat, edible oils, electricity, wood, leather
Peru	 copper, gold, lead, zinc, tin, iron ore, molybdenum, silver, crude petroleum, petroleum products, natural gas, coffee, asparagus, other vegetables, fruit, apparel, textiles, fishmeal, fish, chemicals, fabricated metal products, machinery, alloys
Philippines	 semiconductors, electronic products, transport equipment, garments, copper products, petroleum products, coconut oil, fruits
Pitcairn Islands	 fruits, vegetables, curios, stamps
Poland	 machinery, transport equipment, food, live animals
Portugal	 agricultural products, food products, wine, oil products, chemical products, plastics, rubber, hides, leather, wood, cork, wood pulp, paper, textile materials, clothing, footwear, machinery, tools, base metals
Puerto Rico	 chemicals, electronics, apparel, canned tuna, rum, beverage concentrates, medical equipment
Qatar	 natural gas, petroleum products, fertilizers, steel
Romania	 machinery, equipment, metals, metal products, textiles, footwear, chemicals, agricultural products, minerals, fuels
Russia	 petroleum, petroleum products, natural gas, metals, wood, wood products, chemicals
Rwanda	 coffee, tea, hides, tin ore
Saint Helena, Ascension, and Tristan da Cunha	 fish, coffee, handicrafts
Saint Kitts and Nevis	 machinery, food, electronics, beverages, tobacco
Saint Lucia	 bananas, clothing, cocoa, avacados, mangoes, coconut oil
Saint Pierre and Miquelon	 fish, fish products, soybeans, animal feed, mollusks, crustaceans, fox, mink pelts
Saint Vincent and the Grenadines	 bananas, eddoes, dasheen (taro), arrowroot starch, tennis racquets
Samoa	 fish, coconut, copra, taro, automotive parts, garments, beer
San Marino	 building stone, lime, wood, chestnuts, wheat, wine, baked goods, hides, ceramics
Sao Tome and Principe	 cocoa, copra, coffee, palm oil
Saudi Arabia	 petroleum, petroleum products
Senegal	 fish, peanuts, petroleum products, phosphates, cotton
Serbia	 iron, steel, rubber, clothes, wheat, fruit, vegetables, nonferrous metals, electric appliances, metal products, weapons, ammunition
Seychelles	 canned tuna, frozen fish, cinnamon bark, copra, petroleum products
Sierra Leone	 diamonds, rutile, cocoa, coffee, fish
Singapore	 machinery, pharmaceuticals, chemicals, refined petroleum products
Sint Maarten	 sugar
Slovakia	 machinery, electrical equipment, vehicles, base metals, chemicals, minerals, plastics
Slovenia	 manufactured goods, machinery, transport equipment, chemicals, food
Solomon Islands	 timber, fish, copra, palm oil, cocoa
Somalia	 livestock, bananas, hides, fish, charcoal, scrap metal
South Africa	 gold, diamonds, platinum, other metals, minerals, machinery, equipment
Spain	 machinery, motor vehicles, foodstuffs, pharmaceuticals, medicines, other consumer goods
Sri Lanka	 textiles, apparel, tea, spices, rubber manufactures, precious stones, coconut products, fish
Sudan	 oil, petroleum products, cotton, sesame, livestock, groundnuts, gum arabic, sugar
Suriname	 alumina, gold, crude oil, lumber, shrimp, fish, rice, bananas
Swaziland	 soft drink concentrates, sugar, wood pulp, cotton yarn, refrigerators, citrus, canned fruit
Sweden	 machinery, motor vehicles, paper products, pulp, wood, iron, steel products, chemicals
Switzerland	 machinery, chemicals, metals, watches, agricultural products
Syria	 crude oil, minerals, petroleum products, fruits, vegetables, cotton fiber, textiles, clothing, meat, live animals, wheat
Taiwan	 electronics, flat panels, machinery, metals, textiles, plastics, chemicals, optical, photographic, measuring, medical instruments
Tajikistan	 aluminum, electricity, cotton, fruits, vegetable oil, textiles
Tanzania	 gold, coffee, cashew nuts, manufactures, cotton
Thailand	 textiles, footwear, fishery products, rice, rubber, jewelry, automobiles, computers, electrical appliances
Timor-Leste	 oil, coffee, sandalwood, marble 
Togo	 reexports, cotton, phosphates, coffee, cocoa
Tokelau	 stamps, copra, handicrafts
Tonga	 squash, fish, vanilla beans, root crops
Trinidad and Tobago	 petroleum, petroleum products, liquefied natural gas, methanol, ammonia, urea, steel products, beverages, cereal, cereal products, sugar, cocoa, coffee, citrus fruit, vegetables, flowers
Tunisia	 clothing, textiles, agricultural products, mechanical goods, phosphates, chemicals, hydrocarbons, electrical equipment
Turkey	 apparel, foodstuffs, textiles, metal manufactures, transport equipment
Turkmenistan	 gas, crude oil, petrochemicals, textiles, cotton fiber
Turks and Caicos Islands	 lobster, conch, conch shells
Tuvalu	 copra, fish
Uganda	 coffee, fish, fish products, tea, cotton, flowers, horticultural products, gold
Ukraine	 metals, fuel, petroleum products, chemicals, machinery, transport equipment, food products
United Arab Emirates	 crude oil, natural gas, reexports, dried fish, dates
United Kingdom	 manufactured goods, fuels, chemicals, food, beverages, tobacco
United States	 soybeans, fruit, corn, chemicals, transistors, aircraft, motor vehicle parts, computers, telecommunications equipment, automobiles, medicines
Uruguay	 beef, soybeans, cellulose, rice, wheat, wood, dairy products, wool
Uzbekistan	 energy products, cotton, gold, mineral fertilizers, metals, textiles, food products, machinery, automobiles
Vanuatu	 copra, beef, cocoa, timber, kava, coffee
Venezuela	 petroleum, bauxite, aluminum, minerals, chemicals, agricultural products, basic manufactures
Vietnam	 clothes, shoes, marine products, crude oil, electronics, wooden products, rice, machinery
Virgin Islands	 refined petroleum products
Wallis and Futuna	 copra, chemicals, construction materials
West Bank	 stone, olives, fruit, vegetables, limestone
Western Sahara	 phosphates
Yemen	 oil, coffee, fish, liquefied natural gas
Zambia	 copper, cobalt, cobalt, electricity, tobacco, flowers, cotton
Zimbabwe	 platinum, cotton, tobacco, gold, ferroalloys, textiles, clothing
